1111111111111111111
100000000000000M001
1000000000000000001
1000000000000000001
100CCCCCCCCCCC00001
1000000000000000001
1000000000000000001
1000E00000000000001
10000000000000000P1
1111111111111111111