1111111111111111
100C000000111111
1P0CCC0000011111
10000C0C000CMCC1
1111110C01111111
111CC00C000000E1
1111111111111111
