11111111111111111111111111111111111111111
10P000000000000000000000000001000000E0001
1CCCCCCC000000000CCCCC0000111100000000001
111100000000CCCCC00000CCCC111111111000001
111100000000000000000000000000M0000000001
1000000CCCCCCCCCCCCCCCC000000000000000001
1CCCCCCCCCCCCCC00000000000000000000000001
1CCCCCCCCCCCCCCCCCCCCCCCC0000000000000001
1CCCCCCCCCCCCCCCCCCCCCCCCCCCCCCCCCCCCCCC1
111111111111111111100M0001111111111111111
11111111111111111110000001111111111111111
11111111111111111110000000111111111111111
1CCCCCCCCCCCCCCCCCC0000000001111111111111
11110CCCCCCCCCCCCCCCCCCC00001111111111111
11111111111111111111111111111111111111111
