111111111111111111111111111111
10P000000000000000000000000001
1CCCCCCC000000000CCCCC00001111
111100000000CCCCC00000CCCC1111
111100000000000000000000000001
1000000CCCCCCCCCCCCCCCC0000001
1CCCCCCCECCCCCC000000000000001
100000000000000000000000000M01
111111111111111111111111111111
