11111111111111111111
10000000000000000001
1E00000000P00000CCC1
10000000000000000001
10011110000CC0000001
1000M01100000CCCCCC1
11111111111111111111