11111111111111111111
10000000000000000001
1000000000000000CCC1
110000000100000000P1
1CCCCCC0000CC0000001
1000M00000000CCCCCC1
11111111111111111111