11111111
1P000001
10000001
10000001
10000001
10000001
100000M1
11111111