11111111111111
10MCCCC000M001
10M0CCCCC00001
10M00ME00000P1
10CCCCCCCC0001
11111111111111
