11111111111111
100CCCC000M001
1000CCCCC00001
10M000E00000P1
10CCCCCCCC0001
11111111111111
