1111111111111111
10010000000C1111
1000011111001111
1P0011E000M01111
1111111111111111