11111111
1M000001
10000001
10000001
10000001
10000001
100000P1
11111111